R 300 300

NO ./src/textures/colorstone.xpm
SO ./src/textures/redbrick.xpm
WE ./src/textures/colorstone.xpm
EA ./src/textures/colorstone.xpm

S ./src/textures/barrel.xpm
F 1,246,200
C 90,50,190

11111111111
1000001
1000001
100S001
1000001
1000221
1000221
111111