111111111111111
100000000000001
100000000000011
100000011111111
11100111
10000001
10010101
10000001
11111111