11111111
10000001
10000001
10000001
11100111
10000001
10000001
10000001
11111111