R 300 300

NO ./src/textures/wood.xpm
SO ./src/textures/redbrick.xpm
WE ./src/textures/bluestone.xpm
EA ./src/textures/colorstone.xpm

S ./src/textures/barrel.xpm
F 1,          246,200
C 90,50,190

11111111111
1000001
1000001
1000001
1000001
1000001
1000001
100000111111111111
1020000000000000001
100E000000200000001
1020000000000000001
1000001111111111111
1000001
1000001
1000001
111111