R 1920 1080
NO /Users/shamil/Desktop/CLionProjects/cub3d/test_cub/textures/colorstone.xpm
SO ./path_to_the_south_texture
WE ./path_to_the_west_texture
EA ./path_to_the_east_texture

S ./path_to_the_sprite_texture
F 1,1,1
C 1,1,1

111111
100001
100001
100001
100001
111111
