R 1920 1080
NO /Users/mismene/Desktop/CLionProjects/cub3d/test_cub/textures/bluestone.xpm
SO ./path_to_the_south_texture
WE ./path_to_the_west_texture
EA ./path_to_the_east_texture

S ./path_to_the_sprite_texture
F 1,1,1
C 1,1,1

11111111111
10000000S001
10000111111
100001
11110111
  1100001
11000111
111111
